AD    = Feiertage in Andorra
AE    = Feiertage in Vereinigte Arabische Emirate
AF    = Feiertage in Afghanistan
AG    = Feiertage in Antigua und Barbuda
AI    = Feiertage in Anguilla
AL    = Feiertage in Albanien
AM    = Feiertage in Armenien
AN_BO = Feiertage in Niederländische Antillen/Bonaire
AN_CU = Feiertage in Niederländische Antillen/Curaçao
AN_MA = Feiertage in Niederländische Antillen/St. Maarten
AN_SA = Feiertage in Niederländische Antillen/Saba und Eustatius
AO    = Feiertage in Angola #
AR    = Feiertage in Argentinien
AS    = Feiertage in Amerikanisch-Samoa
AT    = Feiertage in Österreich
AU_CT = Feiertage in Australien/Canberra
AU_NT = Feiertage in Australien/Nord-Territorium
AU_QU = Feiertage in Australien/Queensland
AU_SA = Feiertage in Australien/Süd-Australien
AU_SW = Feiertage in Australien/Neu-Süd-Wales
AU_TA = Feiertage in Australien/Tasmanien
AU_VI = Feiertage in Australien/Victoria
AU_WA = Feiertage in Australien/West-Australien
AW    = Feiertage in Aruba
AZ    = Feiertage in Aserbaidschan
BA    = Feiertage in Bosnien-Herzegowina
BB    = Feiertage in Barbados
BD    = Feiertage in Bangladesch #
BE    = Feiertage in Belgien
BF    = Feiertage in Burkina Faso
BG    = Feiertage in Bulgarien
BH    = Feiertage in Bahrain
BI    = Feiertage in Burundi #
BJ    = Feiertage in Benin #
BM    = Feiertage in Bermuda
BN    = Feiertage in Brunei
BO    = Feiertage in Bolivien
BR    = Feiertage in Brasilien
BS    = Feiertage in Bahamas
BT    = Feiertage in Bhutan #
BV    = Feiertage in Bouvet-Insel
BW    = Feiertage in Botswana
BY    = Feiertage in Belarus (Weißrußland)
BZ    = Feiertage in Belize
CA_AL = Feiertage in Kanada/Alberta
CA_BC = Feiertage in Kanada/British Columbia
CA_MA = Feiertage in Kanada/Manitoba
CA_NB = Feiertage in Kanada/Neu-Braunschweig
CA_NF = Feiertage in Kanada/Neufundland und Labrador
CA_NS = Feiertage in Kanada/Neu-Schottland
CA_NW = Feiertage in Kanada/Nordwest-Territorien
CA_ON = Feiertage in Kanada/Ontario
CA_PE = Feiertage in Kanada/Prinz-Eduard-Insel
CA_QU = Feiertage in Kanada/Québec
CA_SA = Feiertage in Kanada/Saskatchewan
CA_YU = Feiertage in Kanada/Yukon
CC    = Feiertage in Kokos-Inseln (Keeling)
CD    = Feiertage in Demokratische Republik Kongo #
CF    = Feiertage in Zentralafrikanische Republik #
CG    = Feiertage in Republik Kongo #
CH_AA = Feiertage in Schweiz/Appenzell-Ausserrhoden
CH_AG = Feiertage in Schweiz/Aargau
CH_AI = Feiertage in Schweiz/Appenzell-Innerrhoden
CH_BL = Feiertage in Schweiz/Basel-Land
CH_BN = Feiertage in Schweiz/Bern
CH_BS = Feiertage in Schweiz/Basel-Stadt
CH_FB = Feiertage in Schweiz/Freiburg
CH_GB = Feiertage in Schweiz/Graubünden
CH_GL = Feiertage in Schweiz/Glarus
CH_GV = Feiertage in Schweiz/Genf
CH_JR = Feiertage in Schweiz/Jura
CH_LZ = Feiertage in Schweiz/Luzern
CH_NC = Feiertage in Schweiz/Neuchâtel
CH_NW = Feiertage in Schweiz/Nidwalden
CH_OW = Feiertage in Schweiz/Obwalden
CH_SG = Feiertage in Schweiz/St. Gallen
CH_ST = Feiertage in Schweiz/Solothurn
CH_SW = Feiertage in Schweiz/Schwyz
CH_TC = Feiertage in Schweiz/Ticino
CH_TG = Feiertage in Schweiz/Thurgau
CH_UI = Feiertage in Schweiz/Uri
CH_VD = Feiertage in Schweiz/Vaud
CH_VL = Feiertage in Schweiz/Valais
CH_ZG = Feiertage in Schweiz/Zug
CH_ZR = Feiertage in Schweiz/Zürich
CI    = Feiertage in Elfenbeinküste
CK    = Feiertage in Cook-Inseln
CL    = Feiertage in Chile
CM    = Feiertage in Kamerun
CN    = Feiertage in China
CO    = Feiertage in Kolumbien
CR    = Feiertage in Costa Rica
CU    = Feiertage in Kuba
CV    = Feiertage in Kapverdische-Inseln
CX    = Feiertage in Christmas-Inseln
CY    = Feiertage in Zypern
CZ    = Feiertage in Tschechien
DE_BA = Feiertage in Deutschland/Bayern
DE_BB = Feiertage in Deutschland/Brandenburg
DE_BL = Feiertage in Deutschland/Berlin
DE_BR = Feiertage in Deutschland/Bremen
DE_BW = Feiertage in Deutschland/Baden-Württenberg
DE_HA = Feiertage in Deutschland/Hamburg
DE_HS = Feiertage in Deutschland/Hessen
DE_MV = Feiertage in Deutschland/Mecklenburg-Vorpommern
DE_NS = Feiertage in Deutschland/Niedersachsen
DE_NW = Feiertage in Deutschland/Nordrhein-Westfalen
DE_RP = Feiertage in Deutschland/Rheinland-Pfalz
DE_SA = Feiertage in Deutschland/Sachsen-Anhalt
DE_SH = Feiertage in Deutschland/Schleswig-Holstein
DE_SL = Feiertage in Deutschland/Saarland
DE_SN = Feiertage in Deutschland/Sachsen
DE_TR = Feiertage in Deutschland/Thüringen
DJ    = Feiertage in Djibouti
DK    = Feiertage in Dänemark
DM    = Feiertage in Dominica
DO    = Feiertage in Dominikanische Republik
DZ    = Feiertage in Algerien
EC    = Feiertage in Ecuador
EE    = Feiertage in Estland
EG    = Feiertage in Ägypten
EH    = Feiertage in West-Sahara
ER    = Feiertage in Eritrea
ES    = Feiertage in Spanien
ET    = Feiertage in Äthiopien
FI    = Feiertage in Finnland
FJ    = Feiertage in Fidschi #
FK    = Feiertage in Falkland-Inseln (Malvinas)
FM    = Feiertage in Föderierte Staaten von Mikronesien
FO    = Feiertage in Färöer
FR    = Feiertage in Frankreich
GA    = Feiertage in Gabun #
GB_EN = Feiertage in Großbritannien/England und Wales
GB_NI = Feiertage in Großbritannien/Nord-Irland
GB_SL = Feiertage in Großbritannien/Schottland
GD    = Feiertage in Grenada
GE    = Feiertage in Georgien
GF    = Feiertage in Französisch Guayana
GH    = Feiertage in Ghana
GI    = Feiertage in Gibraltar
GL    = Feiertage in Grönland
GM    = Feiertage in Gambia
GN    = Feiertage in Guinea
GP    = Feiertage in Guadeloupe
GQ    = Feiertage in Äquatorial Guinea
GR    = Feiertage in Griechenland
GS    = Feiertage in Südgeorgien und Süd-Sandwichinseln
GT    = Feiertage in Guatemala
GU    = Feiertage in Guam
GW    = Feiertage in Guinea-Bissau #
GY    = Feiertage in Guyana #
HK    = Feiertage in Hongkong
HM    = Feiertage in Heard- und Mc Donald-Inseln
HN    = Feiertage in Honduras
HR    = Feiertage in Kroatien
HT    = Feiertage in Haiti
HU    = Feiertage in Ungarn
ID    = Feiertage in Indonesien #
IE    = Feiertage in Irland
IL    = Feiertage in Israel
IN    = Feiertage in Indien #
IQ    = Feiertage in Irak
IR    = Feiertage in Islamische Republik Iran
IS    = Feiertage in Island
IT    = Feiertage in Italien
JM    = Feiertage in Jamaica
JO    = Feiertage in Jordanien
JP    = Feiertage in Japan
KE    = Feiertage in Kenia #
KG    = Feiertage in Kirgisien
KH    = Feiertage in Kambodscha #
KI    = Feiertage in Kiribati #
KM    = Feiertage in Komoren
KN    = Feiertage in St. Kitts und Nevis
KP    = Feiertage in Demokratische Volksrepublik Korea
KR    = Feiertage in Republik Korea
KW    = Feiertage in Kuwait
KY    = Feiertage in Cayman-Inseln
KZ    = Feiertage in Kasachstan
LA    = Feiertage in Demokratische Volksrepublik Laos #
LB    = Feiertage in Libanon
LC    = Feiertage in St. Lucia
LI    = Feiertage in Liechtenstein
LK    = Feiertage in Sri Lanka #
LR    = Feiertage in Liberia
LS    = Feiertage in Lesotho
LT    = Feiertage in Litauen
LU    = Feiertage in Luxemburg
LV    = Feiertage in Lettland
LY    = Feiertage in Libysch-Arabische Dschamahirija (Libyen)
MA    = Feiertage in Marokko
MC    = Feiertage in Monaco
MD    = Feiertage in Republik Moldawien
MG    = Feiertage in Madagaskar #
MH    = Feiertage in Marshall-Inseln
MK    = Feiertage in Frühere Yugoslawische Republik Mazedonien
ML    = Feiertage in Mali
MN    = Feiertage in Mongolei #
MO    = Feiertage in Macao
MP    = Feiertage in Nord-Marianen (Saipan)
MQ    = Feiertage in Martinique
MR    = Feiertage in Mauretanien
MS    = Feiertage in Montserrat
MT    = Feiertage in Malta
MU    = Feiertage in Mauritius
MV    = Feiertage in Malediven
MW    = Feiertage in Malawi
MX    = Feiertage in Mexiko
MY    = Feiertage in Malaysia #
MZ    = Feiertage in Moçambique
NA    = Feiertage in Namibia
NC    = Feiertage in Neukaledonien
NE    = Feiertage in Niger
NF    = Feiertage in Norfolk-Inseln
NG    = Feiertage in Nigeria
NI    = Feiertage in Nicaragua
NL    = Feiertage in Niederlande
NM    = Feiertage in Myanmar (Birma) #
NO    = Feiertage in Norwegen
NP    = Feiertage in Nepal #
NR    = Feiertage in Nauru
NU    = Feiertage in Niue
NZ    = Feiertage in Neuseeland
OM    = Feiertage in Oman
PA    = Feiertage in Panama
PE    = Feiertage in Peru
PF    = Feiertage in Französisch-Polynesien
PG    = Feiertage in Papua Neuguinea
PH    = Feiertage in Philippinen
PK    = Feiertage in Pakistan
PL    = Feiertage in Polen
PM    = Feiertage in Saint-Pierre und Miquelon
PN    = Feiertage in Pitcairn
PR    = Feiertage in Puerto Rico
PT    = Feiertage in Portugal
PW    = Feiertage in Palau
PY    = Feiertage in Paraguay
QA    = Feiertage in Katar
RE    = Feiertage in Réunion
RO    = Feiertage in Rumänien
RU    = Feiertage in Russische Föderation
RW    = Feiertage in Ruanda
SA    = Feiertage in Saudi Arabien
SB    = Feiertage in Salomonen
SC    = Feiertage in Seychellen
SD    = Feiertage in Sudan
SE    = Feiertage in Schweden
SG    = Feiertage in Singapur #
SH    = Feiertage in St. Helena
SI    = Feiertage in Slowenien
SJ    = Feiertage in Spitzbergen und Jan Mayen-Inseln
SK    = Feiertage in Slowakei
SL    = Feiertage in Sierra Leone
SM    = Feiertage in San Marino
SN    = Feiertage in Senegal
SO    = Feiertage in Somalia
SR    = Feiertage in Surinam #
ST    = Feiertage in Sao Tomé und Principe
SV    = Feiertage in El Salvador
SY    = Feiertage in Syrisch-Arabische Republik (Syrien)
SZ    = Feiertage in Swasiland
TC    = Feiertage in Turks- und Caicos-Inseln
TD    = Feiertage in Tschad
TG    = Feiertage in Togo #
TH    = Feiertage in Thailand #
TJ    = Feiertage in Tadschikistan
TK    = Feiertage in Tokelau
TM    = Feiertage in Turkmenistan
TN    = Feiertage in Tunesien
TO    = Feiertage in Tonga
TR    = Feiertage in Türkei
TT    = Feiertage in Trinidad und Tobago #
TV    = Feiertage in Tuvalu
TW    = Feiertage in Taiwan
TZ    = Feiertage in Tansania
UA    = Feiertage in Ukraine
UG    = Feiertage in Uganda
US_AK = Feiertage in Vereinigte Staaten/Alaska
US_AL = Feiertage in Vereinigte Staaten/Alabama
US_AR = Feiertage in Vereinigte Staaten/Arkansas
US_AZ = Feiertage in Vereinigte Staaten/Arizona
US_CA = Feiertage in Vereinigte Staaten/Kalifornien
US_CO = Feiertage in Vereinigte Staaten/Colorado
US_CT = Feiertage in Vereinigte Staaten/Connecticut
US_DC = Feiertage in Vereinigte Staaten/District of Columbia
US_DE = Feiertage in Vereinigte Staaten/Delaware
US_FL = Feiertage in Vereinigte Staaten/Florida
US_GA = Feiertage in Vereinigte Staaten/Georgia
US_HI = Feiertage in Vereinigte Staaten/Hawaii
US_IA = Feiertage in Vereinigte Staaten/Iowa
US_ID = Feiertage in Vereinigte Staaten/Idaho
US_IL = Feiertage in Vereinigte Staaten/Illinois
US_IN = Feiertage in Vereinigte Staaten/Indiana
US_KS = Feiertage in Vereinigte Staaten/Kansas
US_KY = Feiertage in Vereinigte Staaten/Kentucky
US_LA = Feiertage in Vereinigte Staaten/Louisiana
US_MA = Feiertage in Vereinigte Staaten/Massachusetts
US_MD = Feiertage in Vereinigte Staaten/Maryland
US_ME = Feiertage in Vereinigte Staaten/Maine
US_MI = Feiertage in Vereinigte Staaten/Michigan
US_MN = Feiertage in Vereinigte Staaten/Minnesota
US_MO = Feiertage in Vereinigte Staaten/Missouri
US_MS = Feiertage in Vereinigte Staaten/Mississippi
US_MT = Feiertage in Vereinigte Staaten/Montana
US_NC = Feiertage in Vereinigte Staaten/Nord-Carolina
US_ND = Feiertage in Vereinigte Staaten/Nord-Dakota
US_NE = Feiertage in Vereinigte Staaten/Nebraska
US_NH = Feiertage in Vereinigte Staaten/New Hampshire
US_NJ = Feiertage in Vereinigte Staaten/New Jersey
US_NM = Feiertage in Vereinigte Staaten/Neu-Mexiko
US_NV = Feiertage in Vereinigte Staaten/Nevada
US_NY = Feiertage in Vereinigte Staaten/New York
US_OH = Feiertage in Vereinigte Staaten/Ohio
US_OK = Feiertage in Vereinigte Staaten/Oklahoma
US_OR = Feiertage in Vereinigte Staaten/Oregon
US_PA = Feiertage in Vereinigte Staaten/Pennsylvania
US_RI = Feiertage in Vereinigte Staaten/Rhode Island
US_SC = Feiertage in Vereinigte Staaten/Süd-Carolina
US_SD = Feiertage in Vereinigte Staaten/Süd-Dakota
US_TN = Feiertage in Vereinigte Staaten/Tennessee
US_TX = Feiertage in Vereinigte Staaten/Texas
US_UT = Feiertage in Vereinigte Staaten/Utah
US_VA = Feiertage in Vereinigte Staaten/Virginia
US_VT = Feiertage in Vereinigte Staaten/Vermont
US_WA = Feiertage in Vereinigte Staaten/Washington
US_WI = Feiertage in Vereinigte Staaten/Wisconsin
US_WV = Feiertage in Vereinigte Staaten/West-Virginia
US_WY = Feiertage in Vereinigte Staaten/Wyoming
UY    = Feiertage in Uruguay
UZ    = Feiertage in Usbekistan
VC    = Feiertage in St. Vincent und Grenadinen
VE    = Feiertage in Venezuela
VG    = Feiertage in Britische Jungferninseln
VI    = Feiertage in Amerikanische Jungferninseln
VN    = Feiertage in Vietnam
VU    = Feiertage in Vanuatu
WF    = Feiertage in Wallis- und Futuna-Inseln
WS    = Feiertage in Samoa
YE    = Feiertage in Jemen
YT    = Feiertage in Mayotte
YU    = Feiertage in Serbien und Montenegro
ZA    = Feiertage in Südafrika
ZM    = Feiertage in Sambia
ZW    = Feiertage in Simbabwe
